####################
#P.................#
#.###.#####.#####..#
#G..#.#...#.#...#..#
###.#.###.#.###.#..#
#..................#
####################