####################
#P.................#
#.###.#####.#####.#
#G..#.#...#.#...#.#
###.#.###.#.###.#.#
#..................#
####################