####################
#P.................#
#.###.#####.#####..#
#G..#.#...#.#...#..#
###.#.###.#.###.#..#
#.............G....#
####################