####################
#P.................#
#.###.#####.######.#
#.......G..........#
####################